[
    { "x": 0, "y": 0 },
    { "x": 0, "y": 1 },
    { "x": 0, "y": 2 },
    { "x": 1, "y": 3 },
    { "x": 0, "y": 3 },

    { "x": 7, "y": 4 },
    { "x": 7, "y": 5 },
    { "x": 8, "y": 5 },
    { "x": 9, "y": 5 },

    { "x": 2, "y": 8 },
    { "x": 2, "y": 6 },
    { "x": 2, "y": 9 },
    { "x": 2, "y": 7 }


    
]